#00###########################################################
#38#1909#45#28#1#9#85611#924#0924397#1#7#4#1361#92#4#9#27#62##
#8205#6491#10014231#8#9#4#27#3#3#01#08113#1#84#8616770#7#77#8#
##6#5#31#31#3#2#9#4#665#17#7778#8#028#84#4903424#70#2#1507686#
#93#596#7#09#9#466#7#7#30#27#0#50#5#83#130#5#4#4#7#7#29#7#0#2#
##070#9#526#46889#727242#8#96#0195#7#83#8#6#34#0670#84#97162##
#8#66#80#7#2#69#512#32#4#98#435#0#8316#0007#1#87#2#12#4#0#2#8#
#01554#314#1480#62#9443546#11#3#1#95#05#8#195#90#10#6#6819#27#
#0#6#6#3#75#3#22#74#16#5#499#0#4764#24#4#79#304#35#9#15#3#484#
#9#57794#6#892#83#91#89#05#39#054#5#5#46#0#35#55#56171#678#1##
##916#1#7342#45#607#47#9#871#6#8#109#95#9557#83#04#42#8#582#5#
#64#3166#8#08#25#3#1#7291#1#32#692#08#373#4#85#3#69#6#577#497#
##0#6#7#40#1754#3#21#3#213#28305#526#4#708#7#93161#8#77#663#5#
#07#9#31#14#0#89063#6635#84#1#5#0#69#8269#47#9#6#0382#59#2#62#
##45#85#20#4708#4#8094#408#4249063355#1#95985#5#6#0#8#0#2#0#4#
#95#82#5#874#7#5884#5#299#0#8#5#9#8#49#0#4#393#6402229#49#1#5#
##9#3409#19#69#1#19707#4#316#680#14#99741#9#4#7#83#7#60#22673#
#7563#7#86#71715#41#1#51#6#7#8#0#1#4#9#66378820#553#6#20#0#94#
##2#29#8841#8#6#67#5#6341#7442#068#6#867#3#49#67#6#81#336449##
#2#38#06#3#7#0#6#787#12#453#049#450#9#7#8#50#9#8364#98#5#6#58#
#03#893#9386#3#7#0#401#81#8302#660#613329#540558#5#13#45#73#6#
##823#26#99#2#05#5#55#77#93#1#63#8#8#57#228#6#4#0#65#5#3#6#0##
#07#536#229076#088#3#62#19#50#43662914#2#532#1#41#8596#717#73#
#9#288#6#7#53#1#910975713#93#33#1#0#718694#67#5#901#0#9#091#6#
#06#06083#0573#06#22#1#1#49#27#999#895#8#803#17#7#621#6#1#379#
##16#2#4#0#85#94#2#9#9959#3#5#7#9#7#2#5#0#66#27#16#1#82#96#16#
#5#68#064260#35#2#8#0#6#376#2079#6#41#92#53#5#188#8881#63#8#2#
##8#2#8#4#1#18#42553#63#5#745#01895#44#71#60813#81#0#97#61891#
#206614418#2#75#2#3#42#6#0#035#33#918#77#49#3#2#1#9#2#63#54#1#
#7#67#9#2#9#04#71#9924#55#2#48140482#13992#062#300#80#40660#4#
##91#498#273#09#16#5#91#19104#4#6#55#3#52#53#22#3569#96#1#553#
#60#97#7086#8#5#31#5979#7#37#0#601#97#12#57#1388#9#15#75#394##
##637050#7#2129022#0#4#7#34205#4#22#8888338#99#7#15#434#5#1#2#
#2#2#1#52#742#74#391000240#7#7197#31#27#5#167#99#8#11#9#0157##
#222#78#1371#0#7#0#6#1#0#942#0#1#0#12#6#89#4#06#296#25#2#2#87#
#8#584#3#0#0772#1#01#8#886#2842695#7#5#18#821#20#5#97#9356392#
#32#7#12#77#55#60#8#14#8#37#0#7#5#1#1#0#69#53#5#002#85#8#4#9##
##09#22#4#831#49#66#8776#9#988#42#07#75#6#032#34#610#0#58#264#
#74#3#4#90#3#44#31#99#49#561#76#1#2#50#323#7#00#02#59#2#936#2#
##489#88#9#2#7278706#35#3#51#2#186233#41#1#54#7#8495899703#79#
#5#0#93#70#86#2#97#28#1#39#18#837#6#4#4#365#1#358#6#6#0#09#6##
#33192#5#055#36#46#15#6#310427#4#79#67#9#561#26#4542#6#365#20#
#0#6#4#32#382#23#487#38466#3#83200#06#6#837#7#0#34#60122#3238#
##40#2#4#72#59467#339#3#4#3#87#03#4#1078#4#67#297#69#4#13#8#9#
#68#95817#6#1#8#8#80#8#51334#12#9#26#8#42603#22#58#227#640#07#
#5#6#7#6#39367#4#99#8261#9#056#9#83#80#86#184#5#92#5#3#5#3#6##
#3855#90#3#1#6337#94#2#80#1#9#457#4#4#4#718#84#1#88609119576##
#6#9#66#358#318#906#3#38#43219#13#8#9706#0#5#565#7#9#1#44#232#
#7#18233#5127#7#02#09#6#0#0#0#9#2762#6#88#1190#3689#1#2#1#5#7#
##2#7#4751#08#88#37#864064#7#3668#94#933#7#59#219#6449#53718##
#057#52#4#66#36#4#707#9#0#57#7#2#10916#5#0#7#49#4111#80#0#1#5#
##8#29#26#28266432#5#100#91#1#2#4#0#6#1#660410#62#88#35#49#1##
#8#78#80#30#50#6#8#469#2#0354#7#1#0#033229#4#64#0#9#66#0#3064#
##16#11#37#3976#9151#6#957#9#08#5169#8#1#727#18742208#16#8#5##
#9#59#87#3#45#446#6#810#47#92#48#6#112#21#1#77#58#6#77#433170#
#837#3211809#5#9#353#9#8342#45#4634#0#31#7#86#72#7#809#4#1#4##
##0#18#5#06#342#51#7#32#1#640#3#4#22493#4#49#2#847478#0#78#52#
##909#3704#462#89#8#8#1#4#3#7#240#7#5#42722#534#9#51#83#418#4#
#2#5#4#8#5#8#23#9#5#93#426#0#1#508#3347#9#38#7#222#73#6021#30#
#6#6#4006#6#16#39#7#5#03#230#8#45#4#05#961#09187#889139#9#78##
#4174#5#8229407#566916#57#4#97096944#850#4745#6400#29#4472#63#
###########################################################40#
