#50###################################################################################################
#470#98#0#7#80#42#2529#1#99#09#98947#724#149#18#788#477486#02#6#7#80097#5#71#90505#6#47#10#7#9#49#034#
#0#97#72#1744#16#6#72#5639#7#70#85#11#5#53#35#377#62#34#7326#942#1#0#24#82#95#1#2#349#699#11#50#3122##
##5#523#08#123#709380#1#5#69#5#148#05251#8#21213#66#6166#1#475#24228#8#90#41#995628#095#4#786#32#6#41#
##1#39#9#6#9#02#5#9#98#39#66757#3#16#8#8732#43#43#3#0#8#6#4#0#6#6#2#5876#17694#88#654#66#0#3#95#938#6#
#853225#00213#77#577398#497#0#1#87#13763#98#54#0#7677#27#13#2616#2#7#1#308#5#11#0#2#807#561922#35#036#
##2#0#47#1#2#0#6#2#5#0#7#9#55#95#9106#4#17400#8#3#0#98#495#094#128#778#2#1#795#712#14#341#4#3#6#53#9##
#220318680#1#9#150#46734#89#41#88#2#01#9#9#3#5#77#64#5#90#96#975#778#6211989#806#64#513#10#0#147#0#76#
##7#57#2#74#0183#21#6#6#4#51#65#4#2#2299612#068#250#8#7#464#3#9#30#26#1#8#84#27#5#76#06#0#87#0#914#72#
#033#43#1#4941#319#94203#92#87#930#1#8#17#2#0#95#21076#62#66#0970351#254#3970#69190#527022#0#5335#9#9#
#9#31#829#28#384#27#8#6#0#87#211#8#853#0#0#0728397#7#771#2#26#29#38#93#8#58#74#6#3#3#5#7#88624#8#36#9#
#75#35#5#6#75#6#9#5#4781#53#74#59#9#9#867#72#3#86#66#0#18#05946#36#1#3097#821#1209192#1#43#4#3#6#1#61#
#5#3#10#565#916428995#4#03#76#0#0389#3#6#66#6#07#53#7173500#7#53#52930#7#3#6#06#3#6#2#38#3#3#31#0190##
##685#527#78#1#5#4#0#9805775#3#7#9#31#7#4#757443#1#40#23#4#7#7#26#52#742206#04#31#74#1#8#6734#0313#33#
#47#280#05#49#8#1#670#85#2#43496124475474#07#4#44#746#0#88821140#4#039#5#4#2#96#5129#8186#4#4243#59#7#
#7#39#05#261303778#361#2#3#8#9#07#36#58#40#33#91#558#402#9#0#8#6#1556#05#98239#2#65#3#27#813#5#25#0#2#
#80#38#560#44#0#4#9#8#3#687#8244#356#85#9#7#129#10#529#5#3#0#8#42#0#360#70#4#34458#10242582#40#189#79#
##1#5#13#36#54#033#84892#7#5#2#569#63#92#43#70#94#9#4#4928965#3#31#79#362#0558#00#1#1#8#7#86#23#0#653#
#11#66#5#6#347#6#38#86#4942#0#06#79#94#62#30#2434#397#1#85#485#7#26#544#49#6#946#649#6#488#291#0#7#25#
#5#3#176#26#1#6#12#60#53#650761#0806#01#34#5#2#8272#1#9#5#953#022#4#7#66#112#59#1#9#67582#3#3#737#038#
#50#01#11#85301#378#4#730#6#5#83#86#05#78#363#56#4#8#6#3010#17#813#0523#67#11#9#9#46#6#7#962#35#94#31#
#9#7#41#113#18#377#72843#907#22#0#4#973#360#208#7#1#159#56#11#8#0#24#6#379865#4#748938#58#9#06#5#4966#
#24#56#10#273#52#559#1#165#21#02#133#8#00#4#1#88#090#7#0525#851887#7#32#8#6#61266#86#59#072880#75#31##
##7#4#50#1#8#7#3#7#36#4#079#34138#9#9#196#80#10289#990#56#76#8#2#9#8#2039#8451#13#38#8#8#0#5#18#2#7#0#
#3341400#0243#1#9056440#3#73#58#818776#7#91#34#6#831#186#2383#10#52#072#927#5#8409#678967#33#23#7160##
#4#1#5#80#64#47#62#4#3#0447#112573#9#1#3#2#7#8#908#67#6#7#7#312#0#848#211#98#7#1#81#7#0#00#55#546#2#1#
##45#51#71#8#569#08#379#1#0#14#6#6#9#9#76#62#532#200#37#5926#8#84#6#368#79#244#50#66#548#8#853#75#906#
#50#45#7#86#1#0#0#2#25#276#3225#36#4219#844322#672#595017#75045#373636#482#1#751#1#44#3#7#130#57#99#0#
##0#25639#615#42426#7#0#81#3#3#4#715#443#9#6#4#0#8#21#52#783#6#3#5#0#886#36#6#70#51#7237482#29#863#01#
#5713#7#9#33#28#36#8#076205#175635#233#21#6#2640#42#032#68#2#7200#9#77#54#1967#62#7#3#6#1#525#97#4#70#
#4#6#2#5701#72#32287696#1#89#7#1#95#6#7#73#2#9#5#28#63#6#461#5#1#6729#64#0#4#55#2#62#8#2917#152#1#14##
#4#0#25#16#16#9#2#0#89#8#9#88#63#13#9617#39167#190#7706#2#18#9#5659#426#57#081#67#2#364#0#60#5#4730#3#
##3306#4#8#3#821#054#54#408#5#3351#65#1#74#4#48#0#1#3#2628#2#2#4#5#07#2#9#06#32#0#5#4#453#4#861#7#044#
#4#6#2#9431#21#171#1#2#4#54#0455#4251#4#4#936169#0#9#1#9#37389#0#1#66642670#60#93#950#87#5#155#73#39##
#544#5#0#5#73#3#73#28786#860#5#0#2#6#224#8#7#03#3432#1#5339#2#4#19799#6#1#84#82#714#7#9#2#989#90#2#37#
#7#5#88#7573#8160#319#7#45#1682#160#3#6#018#5#2#51#8#04#0#521973#48#60#28#9#494#7#063182122#798#9375##
#05#0#2059#8#0#9#51#51#47#40#4#75#4#74#7#05#20#5#3#68#2#43#06#0#3#18035#51#6#703#256#4#0#8#6#74#7#293#
#0#370#9#2#6667#6#070#65#35#0905#8#58#27775581914#22#9820#31#7#2025#00#45#88407#452#81#0#4#069#06334##
#618#285#615#4#4#13#73#0#8#51#0#8359#81#0#0#8#4#7#758#32#20#700#3#651#5#4#4#2#40#2#91#5380#2#568#32#8#
#2#7081#0#9#4440241#5799#34411#34#3#96#76#12#03#0847#7#9534#7#2704#2#091#193#15#7#9#22#4#290410#130#7#
#37#5#981385#06#3#539#474#79#23#58#04#29#2461#71#6#637825#8236#7#6#88#9#87#04#1#186292#53#1#54#650#82#
#2#1798#4#2#212#534#4#19#80#8#96#080#4#984#543#10#79#0#9#0#2#89#6472#551#066#0315#04#68#2#3#643#9#6#1#
#3#1#43#5#48#6470#85#44#92#457#207#90385#4#6#295#04#5#6196268#0433#5558#98#71#4#8#701#8572#81#1905#01#
#5#7#390#16#6#9#20#20300#183#141#06#36#24#82108#0#4#56#5#24#3415#14#4#2#1#30#3#656#3#79#99#1#6#9#64#2#
##6#78#17#8#082#5#8#0#1#07#2396#3#674#1#22#0#100#059#77#8034#3#40#72#50839#8113#8#550#252#0347#65#713#
#32#418#5#44#3#79#3#75#55#4#8#18#71#8#58#15#7#9#9#2#67939#9#71#24#4549#4#35#07#6#5#2#37#989#5#9#49#1##
#9#2#32#67#562#7#4997677#772#39#55#61#32#7#16#668#30#6#1#960#84#924#22652#439#716#06#2#771#0369#5#192#
#8#74411#443#08#27#3#5#640#2#7#9#8#47328391#411#67149#3#6#7#30#11#7703#2#01#22#4#41#7519#97#0#97#5#01#
#48#52#82#6674#4#627#7#8#30#573352#5#1#0#1#67#02#8#3#7173226#44#19#7#7146#33#7#114#7#9#9#1#56451#2#34#
##426#6#598#03115#3#9#4#08#68#9#7#4#283#5340#07#131#5#7#6#588#2#3#2#22#018#35169#84#7#8#6#09#3#5#782##
#66#2#09#4#222#465029202#559#8#5#0498#1#85#1#9#11#01#6663#40#044#899#2#62#92#7#56#4#922#049#9#8524#23#
##4#541#52#5#0801#3#39#1#76#0#791#0#06#9#363891#85#178#108#7#1#649#38531#4#747#2#6#74#78#2#7441#9#7#7#
#89#0#075#77#6#8#083#35#0#48915#2028#878841#95#7#8177#36#834#2#5#06#8#9#343#7957#9#4#03#3#9#7#943#7#5#
##022#6#910#57177#755#44898#3#921#5#7#1#1#4#3#597#7#4#6152#5399#7#5#94#9#7165#506693#0#527019#1#805#3#
##3#057#4#10#4#3069#248#4#37#58#566437#2#1#5#08#4#4#890#8#1#1#5729#0#6#4#0#0#8#8#5#1645#9#1#36#81#214#
#4#726#741454766#9#41#8#57970#89#3#0#2#284529#1419595#78#776#4#9#5595169#87088547#8#44#27#7#3671#41#0#
#4#4#60#6#9#1#3#22#7#1724#7#64#4266#6#4#9#4#6419#9#39#221#720#2#9#0#8#6#2#5#5#05#980#1#11#18#6#84#048#
#546#38#2#4729323#5#7#8#29#3#5053#355167326#4#9#964#57#91#15#86872#47#6#09#257#320#9576#9#9#586#7#46##
##1#5#43#0#3#1#8#93#387#8#8#5#1#229#5#69#9#194#287#5#852626#6#0#7#2#2#236#42#356#5#8#8#98#461#42#61#5#
#64993#515723#8010#61#7#4#544#11#6#2#49#181#89#36#0#6#3#5#61#667916#926#601#09#01#59988041#0#47#5#433#
#0#3#18#9#0#65#8#5#2#087825#001#6#30#8#92#543#263224#1#792#9#8#7#4#334#2#7#65#75#45#8#0#70#70#6619#1##
##331#49#786#4307#7#5#3#0#41#6#811#7#072#252#10#5#1#609#28#78018#41#2#720310#4#691#62#870#1#19#3#4676#
#3#8#71#877#3#33#3805561#4#230#4#6#71#62#9#7#8#1#95#8#452#63#4#36#322#8#8#8#76#2#53#020#9#0#7#2#72#94#
#84#76#40#1#3029#4#28#500008#67#5#32#7601#6503#73#50#66#25#5#741374#13041#2#1#337#09#02#3#3#6#331#977#
##69#256#6#58#30#13337#55#0#35#5#2#42#7#08#3#91400#69#8#77#0604#1#4#00#6#11#2#6#48585#40#382#79#153#1#
#6#87#1#5901#99#5#4#5#0#07#0#8#28203#2#3#4365#84#04#23655217#5#886#4#4#7#6#96#7#6#7#39#736#43#187#1#8#
##07#83#1#7#3#54918#80657#194#59#7#71#418#2#966#11#5#9#8#62#6#49#9890#948#48#2#2#91#4596#30#7#80#20#0#
#96#8#27884#87#9#9#277#5#8#2#71#2#9#02#51#994#8#2#8#789#55#592#558#07972#78#816#95#0#88#29953404#4#94#
#8#6#24#9#648#99#6#9#7#3#1#103842#3#808986#9#1792#54#2#78#7#9#27#0#4#47#56#7#945#5#01#23#1#57#823#1#7#
#92#2#3996#5#61166#5#5#5#638#0#7#264#4#3#766#9#1#3#5#46#27#794#2#61#4#86#694816#4481#14#830#2#82#3#77#
##568800#23#2#3#8#23#39#2#5#1#83#5#3#52#14#9363792#23#9#101#6#83#7#2766#66#91#039#102539#2#6#26#8#9#9#
#4#9#9#09990549292#57#965#497#8#3#910#0#5#4#5#9#827#67087#36534#8#6#2#37#563#8#84971#5#08#2#19#881339#
#80#005#1#4#4#7#4495#11#703#72013672#05#65#0#99#0#2#65#1#87#8#355#5046#365#6534#4#665#5#0#779#98#04#8#
##586#41#1832#561#9#1#6#9#1#2#23#95#94#9#490#9#029952#6#4#7#46#0#53#2#57#7#98#4#81#0#04088#0#35#98#11#
#41#86#6#74#399#9#26#7375#95#1#7#86#3#184#8#61#76#40#39#7#14#83#01#4#5#09390#1#10#12#2#1#7373#37#16#4#
##91#07#95#52#00#4#92#4#52#6#25744#64#8#50#78#34#8#94#526001#0#99#10178#1#4#9628#20#01#0#8#15#6#90#1##
#6#2#0136#66#31#75#3#8#7#7182#3#1#3872989#52#13#11#2#27#12#4208#2069#9#92#63#5#7#801#8#4#082#0694#812#
#4#914#303#38#68#137#26#9#6#7808#675#1#20#83#0#0#5#79#937#1#82#01#6#206#09#48#809#4#6#490#6#90#1507#1#
#6014#65#09#8#0#76#147#042#44#1776#8#62#7270#877#76683#1#941#4229#011#227#29#9#8#80#77#751995#1#6#698#
#6#3#8#0#5#01445#4#9#899#65#3#3#6#72#6#3#9#399#035#3#21957#0546#01#9#89#8#71447#7#93#6768#0#96#98070##
##94#6#3#84#07#5205#06#4#33#8042#7#84#829#36#0#1#5869#96#02#5#86283#28#6#7#85#68264#47#84#72302#2#183#
#90#724746#83#6#06#21#3#633#3#43894#202#01#4#79#4#40#63#7#4#0#0#6#1#60206588#0#4#8#7#72#105#3#3#118#1#
#8#3#04#9255#379934#883#9#033#9#23#2#2#073#36#0#60226#5090#060#5#2#30#4#51#0994#51#3#259#89935#53#4#7#
#17931#00#5#68#70#922#69#54#40#1523#9041#0#3#55062#811#0#38#931#6489#6#42#0#19#32#745#8#251#133#56#12#
#5#3#876#0214#3#2#4#01#54#32#2#7#9#5#1#80#7#1#8#73#1#4#67#156#50#8#5#9#492327#7#64#55#036#528#84#80#3#
##1#7#0#25#38#8#7386#54#10#3573#8#02#1#87601#1#116691#3473#9#12#746#594#6#20#226#7504565#42#966#3#614#
#9868750#8#12077#96#2239#08#91#4467#5#69#75#6658#79#196#5#2113#183#8#9#492#0#0#6482#4#6#55#309#400#2##
#2#91#8#0#8#3#5#7298#11#86#3584#8#167#8#637#0#31#4#60#02#52#723#6#61#070#6#7#98#87#212#42#31#7#01#4#5#
##7#5#349#681#156#9#708741#4#0#24#4#1164#9#7#9593668857#59#894#5#9#582#3#49#7#3#7#704#98#965#521#4244#
#95#81#02#5#3913#31#32#1#195621#2577#8#963#218#2#60#7#700929#309#022#85#7#9#38#651#4#3#7#7#2#0#09#3#2#
##841#0#455#6#2#6#7#24#5#1#2#048#13#65955#67#10#39#7#53#02#03#232#468#5#37170#54#7#763#145#68#6#68#94#
#11#6#53#9#0#7902#86989#071#8#0954#0#3#4#810689430#01326#57#3#8#62#36#398#4#5222#83#3#153#76#46509#18#
##71624#417#5#3#100#3#20#5#3364#8#81005#57#2#7#5#15#3#580#55323#8039865#71#1#3#639776#4#65#1586#9#831#
#2#5#3#3#1#23#868#73#0#5#935#5#94#3#7#65#30#8#1#30#22#62#9#3#9#79#6#1#3637305#11#84#10#3#39#4#5896#2##
##18#1#622#8#8#4#9#6217227#1#59#8#29#20#7417060031053#2055#6780#06#48#5#8#2#8#1#1#09#15#0#7262#0#1081#
#89#3279#0#5#975178#1#2#6#39#3131#7#38#0#3#6#90#5#5#7335#696#9#8#4#0#8#4#465#8#8#46#72#9#35#8#5#49#3##
##19#92#2272#3#6#3#26#87#53832#7789#0#654#79#806#1772#6#71#4#58044#3#5#01#6#98#289#4#8#28#3#84339#760#
#776#95#9#3#06#1#48#2655#20#333#32#67#3#206#3#2#74#8#04#64#36#84#378279099#0#815#5675#4#1#97#48#7600##
#3#5995383#4#98#38#94#1#26752#213#9#6546#42298#2#7#263#49#39#61323#5#6#2#01691#85#9#10535#3#20#2#8#37#
#27#0#9#8#1573#8#69#7#409#0#64#2#65293#97#1#7#382#627#5#0#1#9#48#470516#90#23#0#2#3629#7#0#0#2415#3#8#
##68#6#851#2#05#07173771#808457791#0#92#13#763#1#06#7596#4#014199#6#3#47#2#3778#25#9#59#163054#4#3844#
###################################################################################################69#
