#11#############################
#2673#286#748#0#69#03#230933#52#
#6#1670#34#6#1028#09124#98#0999#
#17#9#26402198#5#7#6#4#05#87#10#
##92419#3#1#2#970458#0#3#27#6#6#
##9#99#4#90#2#0#5#978#25#4#7098#
#8#76#870#4104#3993#711#8#985#7#
#0#1#59#5351#85#9#64#65674#2#7##
#677#1247#5#86#8#5#83#88#483819#
#9#5#7#9#7#7633#01#4#5#049#9#99#
#6#573#8#265#4#14#2#5063#7#1#15#
#60#1#6#6#1#195#8#76#6#7#7582#5#
#5#695885169#808277#48#75#46#42#
##567#7#37#3#1#5#2758#26#17#562#
#73#560857965#17#8#2#16#39115#3#
#3#19#6#75#9#2#3#761#12#3#44#97#
#82#11#89#0#9#144#3481#9388#72##
#8#5#8#1#32522#6#14#2830#0#01#5#
##9#0#3461#8#92#4#523#95#141#26#
#54115#2#03#51403#8#22594#0#6#2#
##3#9556#7#70#1#999755#499#3071#
#2753#63#143312#5#2#1#8#0#5#1#3#
##4#35#4800#3#0#74#92828#2#94#6#
#255#70#4#78#8#2#64#07#7#9#2903#
##5#9#1330#529373618#89#247#8#0#
#35#043#1#0#28#6#6#1#7#44#431#1#
#2#29#818#39#0840#0#31#6#08#31##
#923#1#9#21#31#530436#013#2#133#
##8#046#26#8#94#28#40#0#7#141#6#
##6053#2#13069#0#69#34#374#1#6##
#74#7#61508#8216#8#2#663#560136#
#############################94#
