#49###################
#009#857#80#83#7#5668#
#5#73#7#27#07#86415#6#
##8#2075#3043#8#4#8#7#
#64#49#84#3#72026#051#
##367#6#886#25#7#63#8#
#32#9134#4#85#9863#79#
#273#2#0920#8#6#3#28##
##009#0#5#512#51131#4#
#19#633#05#2#3#5#8#94#
#6#1#4103#80#3#161#7##
#819#20#6394#5226#289#
##0#9#5#1#1#52#26631##
#7069#5#8#615#0#9#2#1#
##8#6176#0#0#00#42#27#
#75#5#8#88953#219#8#7#
##8#8674#94#5#0#3#79##
#3#22#81227#49#6#4910#
#68#1#47#636#9597#72##
##1#188#00#0#39#06#1##
#5825#288#0#7368#1879#
###################29#
