#04##
#351#
#50##
#021#
##57#
