#04##
#351#
#58##
#921#
##57#
