#82#########
#8604#222#4#
##6#120#84##
#7#5#4#18#6#
#5#8#133#35#
#7917#3#1#0#
##3#8073813#
#74468#32#2#
##3#9#83#54#
#92#18#7439#
##56#518#51#
#########69#
